1111111111
1E00000001
111C111101
100C000101
1011001101
1010C00001
101111C111
100C000C01
111C111101
1PC0C00001
1111111111
