111111111111111111111111111111
100000000000000000000000000001
10P000000011100000011111111001
100000001C1C0000001C100001C101
100000C1C0C1C000000000C1C00001
1000C1C00C1C0000000C1C00000001
10CCCCCCCCCCC000C1C00000000001
1000000C1C0000C1C0000000000001
100000CCC000CCCCCCCCCC00000E01
100000000000000000000000000001
111111111111111111111111111111
