11111111111111111111
10000000000000000001
10100101001101010101
1E100100101001010101
1P0000000C00000000C1
11111111111111111111
