111111111111111
10P000000C00001
100000C0000C001
100000000C000E1
111111111111111
