11111
1PC01
10E01
10001
11111
