11111
1PC01
10E01
10C01
11111
