11111
1P001
1CC11
111E1
11111
