11111
1E0P1
1CCC1
1G111
11111
