11111111
110000011
1000000001
1000000001
110000011
11111111
