1111111111111111111111111111111111
1P1CCCGCCCGCCCGCCCGCCCGCCCGCCCGGE1
101CCCGCCCGCCCGCCCGCCCGCCCGCCCGCC1
1CCC1CCCGCCCGCCCGCCCGCCCGCCCGCCCG1
1CCC1CCCGCCCGCCCGCCCGCCCGCCCGCCCG1
1111111111111111111111111111111111
