11111111111
10C0E0C0001
10111111101
101C00C01C1
101C1110101
1C101GC01C1
10101110101
10000C001C1
1C111111101
1000C0P0C01
11111111111
